###############
#      #   #  #
#  G   #      #
#      #      #
##     #     ##
#             #
#      S      #
#             #
#             #
#             #
#             #
#             #
#            ##
#            ##
###############

