###############
#             #
#             #
#             #
#             #
#    ##       #
#  G ##      ##
#             #
####          #
#             #
#             #
#         #   #
#         #   #
#S        #   # 
###############
