###############
#             #
#             #
#        G  # #
#  ##  ##  ## #
#  ##  ##  ## #
#    S        #
#  ##  ##     #
#  ##  ##     #
#          ## #
#  ##  ##  ## #
#  ##         #
#           ###
#           ### 
###############

