###############
#             #
#           G #
#             #
#     ##      #
#      #      #  
##            #
##            #
#       ##    #
#        #    #
# ####        # 
#   #         #
#        #   ##
#S       #    #
###############
