###############
#             #
#    G        #
##            #
##     ###   ##
#             #
###           #
##     #      #
#      #     S#
#             #
#             #
#             #
#            ##
#          #### 
###############

