###############
#             #
#             #
#             #
#             #
#             #
#             #
#     G       #
#             #
#             #
#             #
#             #
#             #
#S            # 
###############

