###############
#         #   #
##            #
#             #
#             #
#             #
#     G       #
#             #
#             #
#    ####     #
#    #     S  #
#             #
#            ##
#    #        #
###############

