###############
#           # #
#             #
#             #
# #   G ##    #
# #  ####     #
# #        #  #
#          ## #
#          ## #
#     S       #
# ##       ## #
# ##          #   
#  #          #
#            ## 
###############

