###############
#             #
#             #
###     ## G  #
###      #    #
#     #       #
#     #       #
#     #       #
#    ##   ##  #
#  S       ## #
#    ####     #
#             #
#             #
#  #         ## 
###############

